噪	噪
砗	硨
𫚪	鱊
敩	斆
恋	恋
轷	軤
𫏞	𨇰
𪠡	𠬙
椁	槨
写	写
栌	櫨
鹰	鷹
榆	楡
𫎭	䞓
𤞤	玁
绡	綃
𫄰	縍
焘	燾
导	導
嗫	囁
骝	騮
胜	勝
阏	閼
卢	盧
𩾋	䱰
迩	邇
钸	鈽
锘	鍩
红	紅
䴗	鶪
铳	銃
鹓	鵷
𪺪	𤜆
个	個
聂	聶
剩	剰
骥	驥
掼	摜
槠	櫧
笕	筧
络	絡
逦	邐
赞	賛
侠	俠
𫛳	鵩
纱	紗
内	内
铆	鉚
𧏖	蠙
祃	禡
枧	梘
鲗	鰂
𠇹	俓
𫌭	覹
穗	穂
缇	緹
鹋	鶓
𨸄	䦘
绦	絛
𫄴	繂
静	静
鞒	鞽
驰	馳
陦	隯
鳝	鱔
捝	挩
缁	緇
贰	弐
鼹	鼴
贵	貴
𫵷	𫵷
惩	懲
𪫺	憸
钯	鈀
鸿	鴻
唤	喚
臜	臢
颕	頴
换	換
环	環
勋	勲
睁	睜
冯	馮
𫄠	絙
霉	黴
𩖕	𩓣
𩨏	䮳
芗	薌
庙	廟
系	系
䢀	𨊰
蔼	藹
丝	糸
𢬦	𢹿
栉	櫛
毙	斃
𪉄	𩿪
鲞	鯗
阔	闊
𫚊	鰑
车	車
铪	鉿
学	学
喾	嚳
戆	戇
氲	氳
滤	沪
榅	榲
铕	銪
𨷿	䦳
𩡖	𩡣
侧	側
鲎	鱟
窍	竅
类	類
馊	餿
𩠎	𩞄
专	専
椤	欏
𩙰	𩙈
蛳	螄
酸	酸
𪯋	㪎
挦	撏
锟	錕
𫐇	軜
聩	聵
𧳕	𧳟
䲢	鰧
𩽻	𩵹
党	党
酾	釃
劝	勧
铷	銣
挛	攣
𫛨	鵧
体	体
合	合
殒	殞
𪩷	幝
劳	労
叽	嘰
痖	瘂
锈	鏽
讴	謳
鱾	魢
岛	島
𫖬	䪾
拂	払
脔	臠
翚	翬
灭	滅
闳	閎
𤦀	瓕
𡋗	𡑭
𫔊	鏥
䦆	钁
莱	莱
粝	糲
𫌬	𧢄
焖	燜
摈	擯
㻅	璯
旸	暘
呗	唄
滗	潷
莼	蓴
𪥰	嬣
𪡀	嘺
邓	鄧
剑	剣
针	針
猡	玀
䘛	𧝞
坜	壢
𩨁	䮞
𧹗	贃
䯄	騧
枨	棖
隶	隸
馏	餾
䘞	𧜗
搄	揯
价	価
𫔔	鑴
𫖇	鞾
抢	搶
癞	癩
岘	峴
彨	彲
审	審
录	録
缡	縭
𩽽	𩶱
𫞢	𤛱
仇	仇
锰	錳
𫖯	頫
铵	銨
𬹼	𬹼
讧	訌
𫏐	蹔
仿	仿
摆	擺
脏	髒
赶	趕
鳒	鰜
硙	磑
𪎈	䴬
缟	縞
钉	釘
𫛫	鶰
𪥿	嬻
了	了
虾	蝦
筜	簹
镬	鑊
𠵸	𡄣
糁	糝
弦	弦
𫈎	葝
笃	篤
𫟞	訨
瘦	痩
𫕥	霣
𬶮	𬶮
韵	韻
皂	皁
𨀁	躘
疭	瘲
赓	賡
秽	穢
蛴	蠐
蕴	蘊
眍	瞘
𫓾	錥
划	劃
𫛻	𪃒
飑	颮
忏	懺
冬	冬
谞	諝
𠉗	𠏢
𡥧	孻
𫝋	𠐊
营	営
𨱕	𨮂
叹	嘆
蝇	蠅
𪾣	眝
赅	賅
镥	鑥
𫘥	騉
铁	鉄
𫇭	蔿
卜	卜
骓	騅
𫓨	鈛
渑	澠
阛	闤
玩	玩
倾	傾
剀	剴
𪡞	嘳
芦	芦
𩙥	颰
𤶧	𤸫
邮	郵
跞	躒
𪭧	擟
𥧂	𥨐
镮	鐶
辊	輥
镱	鐿
氢	氫
见	見
𫠏	𩵦
赠	贈
乡	郷
硵	磠
葱	葱
测	測
赑	贔
凑	湊
𫏃	䠆
则	則
𫔌	鏾
𫘟	駊
𫛱	鵫
𫇛	艣
裣	襝
锌	鋅
觍	覥
巢	巣
卖	売
诗	詩
镖	鏢
弪	弳
𩾂	䲖
离	離
卺	巹
𫛠	𩿤
锫	錇
呜	嗚
𫜄	鷷
缀	綴
鲃	䰾
𫖰	䫂
𩧬	𩢡
𫔄	鍒
颉	頡
凉	涼
琏	璉
狲	猻
𩾄	𩷰
𫖲	䫟
瓮	甕
𦶟	爇
腌	醃
产	産
乐	楽
肾	腎
详	詳
𩽹	魥
壶	壺
机	機
疟	瘧
锼	鎪
麺	麺
𫔁	鐼
焰	焰
𦈘	䌋
𪳍	欇
纮	紘
芜	蕪
𬬩	𬬩
𫜩	齧
镠	鏐
𪣆	埬
帅	帥
氩	氬
𫍸	謆
虿	蠆
克	克
𥇢	䁪
𫗩	饠
皋	皐
馌	饁
递	逓
溇	漊
哔	嗶
飐	颭
瑷	璦
蛰	蟄
鳌	鰲
𫕚	𩀨
绋	紼
诎	詘
𫝩	嬦
摄	摂
抟	摶
刿	劌
𦟗	𦣎
𬭬	𬭬
佛	仏
𨱅	鉁
㭏	椲
抵	抵
𬘡	𬘡
饬	飭
𧹑	䞈
𨱑	鐄
𦰴	䕳
禄	禄
诳	誑
𪡺	𡃄
骍	騂
𠱞	囃
𫠇	𩖰
钩	鉤
谩	謾
渴	渇
緼	縕
伡	俥
绶	綬
𧌥	𧎈
亏	虧
涚	涗
𪻨	瓄
𩐀	䪗
阒	闃
𫖭	𩒎
坟	墳
伟	偉
𫓸	錽
议	議
粽	粽
𩾅	𩸃
嫔	嬪
财	財
猃	獫
𠴢	𡄔
插	挿
兴	興
𢘙	𢤱
栅	柵
碜	磣
荞	蕎
骋	騁
魇	魘
詟	讋
𫛶	鶒
诇	詗
耢	耮
骚	騒
𪾸	矉
𫖷	𩔑
𫓽	錝
断	断
𩙩	𩘀
𫟤	䡐
蛏	蟶
饾	餖
戗	戧
骊	驪
狭	狭
雳	靂
𫗚	𩟗
罐	缶
绘	絵
𫐗	轐
堕	堕
𪺸	𤠮
轵	軹
𫖅	䪊
扬	揚
睑	瞼
懑	懣
惫	憊
樱	桜
𫛮	䳤
匮	匱
讯	訊
𪺭	犞
镭	鐳
𫍺	𧫝
谴	譴
表	表
慑	懾
螀	螿
绪	緒
钍	釷
盖	蓋
䢂	𨋢
纰	紕
龙	竜
𪉍	鵚
𫍳	諥
𫭼	𫭼
𬶠	𬶠
𬶍	鮀
㲿	瀇
镕	鎔
栈	桟
𫞦	璾
忧	憂
𫠐	魽
𩨋	𩥄
晋	晋
游	遊
𫊹	𧒯
钿	鈿
𨠨	𨣧
执	執
𫍯	諴
飏	颺
飘	飄
袄	襖
沤	漚
蒌	蔞
赉	賚
𠚳	𠠎
𬯀	𬯀
监	監
𫞗	潣
屦	屨
鹇	鷳
喽	嘍
鸸	鴯
戏	戯
觌	覿
砾	礫
啸	嘯
𫠜	齯
帧	幀
韨	韍
𨸟	䧢
浒	滸
𫍶	𧩼
继	継
缰	繮
暅	𣈶
赇	賕
缬	纈
𬨂	𬨂
千	千
镫	鐙
𦈜	䌖
𧿈	𨇁
𪺽	猌
鹩	鷯
鲾	鰏
𦈈	𥿊
哙	噲
层	層
髓	髄
丛	叢
回	回
终	終
龁	齕
呕	嘔
𡋤	壗
嫱	嬙
钤	鈐
鲒	鮚
炼	煉
乌	烏
驸	駙
毕	畢
钲	鉦
萧	蕭
𫄣	繷
𫟢	䜖
习	習
祯	禎
𪠀	𧷎
钢	鋼
𩨌	𩥑
㟜	𡾱
𪹀	𤑹
铮	錚
𫊸	蟜
缂	緙
绗	絎
筿	篠
𬣡	𬣡
𣶩	澅
韪	韙
𬣞	𬣞
𰬸	𰬸
𪶮	𣽏
赁	賃
驿	駅
隐	隠
𫗥	餫
懒	懶
馓	饊
𪚐	𪘯
俊	俊
𩬤	𩰀
运	運
鸼	鵃
溆	漵
䥺	釾
𧉐	𧕟
𣺼	灙
𫔅	鎍
锇	鋨
䲣	䱷
责	責
蓝	藍
陇	隴
鲧	鯀
齿	歯
庆	慶
𢙏	愻
潋	瀲
𤆢	㷍
棂	櫺
𫝫	婡
𫆫	𦡝
凶	兇
啯	嘓
砚	硯
窃	窃
荮	葤
缩	縮
𢽾	斅
称	称
锠	錩
𫌫	𧡴
𪾦	矑
敚	敓
刹	刹
纸	紙
搁	擱
罢	罷
纡	紆
胄	胄
饣	飠
帱	幬
竞	競
龂	齗
𫓺	鐪
𬟽	𬟽
𬱖	𬱖
昆	昆
䲟	鮣
𫜪	齩
跶	躂
酱	醤
𫮃	墠
宾	賓
蓥	鎣
袆	褘
键	鍵
馑	饉
𩙦	𩗀
鲊	鮓
斩	斬
𬳶	𬳶
𫚛	鮵
诓	誆
鞑	韃
籼	秈
𤠋	㺏
号	号
诉	訴
鹆	鵒
笾	籩
钴	鈷
𩨆	𩤙
赌	賭
鼋	黿
垄	壟
辩	弁
狯	獪
铿	鏗
厉	厲
谲	譎
𪫌	徿
阴	陰
啮	齧
悦	悦
托	託
泽	沢
鹫	鷲
𰾄	𰾄
𫘨	騠
蚁	蟻
谯	譙
𨀱	𨄣
𫍛	訜
笔	筆
𫟵	鈗
泛	泛
𫜃	鷣
簖	籪
𫜑	麷
𥮾	篸
钱	銭
𫓧	鈇
卧	臥
滠	灄
轻	軽
锂	鋰
卤	滷
𩖗	䫴
𣺽	𤁣
阊	閶
闺	閨
踬	躓
𥮋	𥸠
刘	劉
𩙬	𩘺
藴	蘊
𪻲	瑻
钦	欽
𪱥	膹
构	構
梾	棶
𪉂	䲰
拐	拐
𣸣	濆
𪢠	囒
𫘦	騊
𫆏	聻
篑	簣
㐹	㑶
飕	颼
𪉊	鷨
蝉	蟬
䉤	籔
泻	瀉
铭	銘
贫	貧
叇	靆
𫓱	鐈
饿	餓
铫	銚
𫌨	覼
𫗭	餵
涟	漣
贽	贄
驳	駁
䞌	𧵳
铩	鎩
阳	陽
𫚕	鰤
床	床
㡎	幓
𫐓	輮
儿	児
规	規
东	東
绰	綽
铂	鉑
诡	詭
𧹖	賟
钆	釓
垱	壋
献	献
躏	躪
殇	殤
鲿	鱨
牍	牘
辚	轔
鳣	鱣
寻	尋
厢	廂
泷	滝
梿	槤
庄	荘
铦	銛
锍	鋶
𪭢	摐
蹿	躥
讨	討
绂	紱
阇	闍
𫁲	䉑
𣗊	樠
坞	塢
䞐	賰
涣	渙
囱	囪
泼	潑
䍠	䍦
茑	蔦
轱	軲
锴	鍇
𫗢	飵
坠	墜
缉	緝
𫜯	𪙏
𪪴	𢍰
烁	爍
闫	閆
槛	檻
里	裏
烦	煩
秆	稈
𫠖	𩿅
飙	飆
宁	寧
栀	梔
𤇭	爖
𫍻	譆
𫟿	鎈
𦈉	緷
从	従
𩽿	𩶰
伙	夥
𫍼	𧬤
𫖃	靧
别	別
𦈛	繓
𩴌	𩴵
痹	痺
注	注
𫑷	醶
𩧮	𩢾
圹	壙
赋	賦
镡	鐔
灏	灝
鸩	鴆
诰	誥
瞩	矚
谳	讞
颖	頴
弃	棄
区	区
灾	災
𨅫	𨇞
𫖑	𩎖
𨟳	𨣞
穑	穡
偾	僨
杯	杯
虑	慮
飒	颯
砖	磚
𫟑	䖅
驽	駑
荚	莢
𫎳	䟆
挟	挟
嬷	嬤
𬙋	𬙋
鸽	鴿
𫚩	𩻬
𦈗	𦃄
沣	灃
𫐆	轣
凫	鳧
鹅	鵝
䎬	䎱
垦	墾
阑	闌
𩾇	鯱
㳕	灡
俭	倹
䜧	䜀
夸	誇
𫗣	飶
嵚	嶔
绥	綏
银	銀
鹤	鶴
𫂖	𥴨
龟	亀
𫚋	鱄
𦰏	蓧
𫜮	齴
珐	琺
链	鏈
𰶎	𰶎
𫌯	䚩
𡺃	嶈
钫	鈁
龛	龕
诫	誡
鿒	鿓
𧹕	䝻
𫝪	𡟫
阐	闡
务	務
创	創
释	釈
𨱍	鎯
𫚎	𩶁
帜	幟
惠	恵
姹	奼
戋	戔
邺	鄴
锒	鋃
𪑅	䵳
𪷽	灒
凄	悽
辋	輞
撵	攆
疴	痾
贺	賀
潍	濰
异	異
惭	慚
缊	縕
虮	蟣
鳔	鰾
鸷	鷙
锏	鐗
𫖕	韝
𫝮	孄
岗	崗
职	職
鲮	鯪
𨱋	錂
𫟥	䡩
纶	綸
𬸪	鷭
㐷	傌
䅉	稏
錾	鏨
厘	釐
局	局
债	債
𫖫	䪴
𩠌	餸
绖	絰
鸵	鴕
钡	鋇
靔	靝
姗	姍
焕	煥
蒙	蒙
愠	慍
锣	鑼
飚	飈
馍	饃
𫞡	爃
脑	脳
宠	寵
涉	渉
𬃊	𬃊
𣗙	㰙
颅	顱
𫘭	騻
腽	膃
鲏	鮍
𦈠	䌥
𪠺	𠽃
剥	剝
锬	錟
𩙨	𩘹
当	当
阓	闠
桩	樁
𫚓	鮤
锚	錨
鸠	鳩
𫜀	鷐
𪿵	𥗇
桤	榿
莺	鶯
偬	傯
归	帰
袯	襏
梁	梁
码	碼
翙	翽
耸	聳
𢙒	憢
𣭤	𣯴
斋	斎
𩾌	鱇
饵	餌
拜	拝
缅	緬
骑	騎
㓥	劏
坚	堅
娲	媧
屉	屜
𪹠	𤓌
𫠊	䮄
鹟	鶲
卫	衛
辽	遼
𫛬	䳜
䯃	𩣑
𪾔	盨
谝	諞
单	単
钠	鈉
㓆	𠗣
门	門
唝	嗊
闰	閏
鸦	鴉
𣔌	樤
症	症
荠	薺
涢	溳
𨐊	𨏥
𨱈	鋉
腭	齶
峃	嶨
𦈞	䌟
𫍱	諯
𫑘	鄟
栾	欒
𪥫	孇
莳	蒔
烧	焼
琐	瑣
𫜊	𪉸
瘆	瘮
幸	幸
𩧶	𩣏
𬣙	𬣙
恒	恒
撷	擷
鲱	鯡
𩏽	𩏪
鉴	鑑
荫	蔭
𫈉	蕳
𫚫	鱢
赀	貲
缋	繢
𩧺	駶
镋	钂
𡝠	㜷
诠	詮
䟢	躎
杩	榪
栏	欄
蛊	蠱
绻	綣
瓣	弁
𢧐	戦
谡	謖
贻	貽
𨉗	軉
𩏾	𩎢
榄	欖
𤿲	麬
脓	膿
嘱	嘱
缎	緞
颐	頤
闯	闖
𫇪	𦱌
鹜	鶩
𦈑	緸
荨	蕁
枡	桝
牵	牽
钟	鍾
删	刪
䓓	薵
镴	鑞
档	檔
𧏗	蠀
𫔀	錬
夫	夫
𡠟	孎
婶	嬸
麹	麹
订	訂
珲	琿
鲬	鯒
樯	檣
还	還
𩟿	𩚛
缨	纓
鸢	鳶
侣	侶
乘	乗
壸	壼
黑	黒
𫎫	贉
𬺓	𬺓
噜	嚕
摇	揺
鸫	鶇
𪮋	㩋
鲪	鮶
梦	夢
据	拠
诃	訶
靓	靚
向	向
痪	瘓
周	周
钘	鈃
𫄢	絥
颂	頌
玮	瑋
鲺	鯴
旷	曠
㭎	棡
冻	凍
询	詢
鸾	鸞
𪪑	㢗
𫆝	𦟼
䦅	鐥
嗳	噯
苧	薴
𪥠	𧹈
轩	軒
鲖	鮦
鲴	鯝
峄	嶧
飔	颸
鳅	鰍
𩧸	𩣫
稣	穌
缳	繯
颢	顥
𩾈	䱙
业	業
岳	岳
𫍴	謱
𪤚	壣
𢘞	𢣭
冈	岡
㶉	鸂
𫌇	襵
𬶭	𬶭
馅	餡
锳	鍈
眦	眥
𫞧	𤩂
𫟳	釲
𠆿	𠌥
𫁺	𥴼
骒	騍
讪	訕
侥	僥
苍	蒼
𨰾	鎷
腾	騰
𬶟	鯻
玱	瑲
凌	凌
缈	緲
镨	鐠
础	礎
缱	繾
困	困
𢫊	𢷮
𪹹	𤒻
龋	齲
靥	靨
𨅬	躝
𬇕	𬇕
怂	慫
鳉	鱂
艳	豔
𫍾	𧭈
𬭭	𬭭
厕	厠
拢	攏
飗	飀
数	数
赢	贏
𫄧	綖
𪲮	櫠
胀	脹
饽	餑
柠	檸
𫓬	鉔
锭	錠
阍	閽
锊	鋝
𥺇	𥽖
𫄥	纚
𬭎	𬭎
郑	鄭
杆	杆
镒	鎰
𫃗	𩏷
𩧳	𩢸
关	関
𫟦	䡵
筼	篔
𪢒	𡂡
缵	纘
迈	邁
𩾁	鯄
龀	齔
盗	盗
剧	劇
赏	賞
㳢	𣾷
账	賬
亿	億
𦨩	𦪽
𫛽	鷅
脸	臉
锡	錫
愿	願
㖊	噚
铧	鏵
赵	趙
𥩟	竚
𫁱	𥶽
饷	餉
䌽	綵
箓	籙
厐	龎
剂	剤
脶	腡
𫛸	鶗
干	幹
椮	槮
𪉅	𪀦
𫍣	詷
鳕	鱈
襕	襴
诋	詆
篓	簍
挡	擋
苇	葦
钮	鈕
诺	諾
肤	膚
𫝦	㛝
萨	薩
沩	潙
𤙯	𤛮
𫄬	緤
馃	餜
巨	巨
皲	皸
𠉂	㒓
𤻊	㿗
踪	蹤
制	制
𪽮	㿖
猪	豬
谁	誰
抡	掄
镏	鎦
烂	爛
诖	詿
𫗪	餧
𬉼	𬉼
唠	嘮
𫗳	𩝽
补	補
餍	饜
缣	縑
尧	堯
浑	渾
烨	燁
牺	犠
诘	詰
𬸦	𬸦
诀	訣
𫀬	䅳
獭	獺
骈	駢
鹃	鵑
𬴃	𬴃
訚	誾
䂵	碽
𫛥	鵊
挽	挽
谚	諺
𫛴	鷤
鳋	鰠
诐	詖
瘅	癉
茕	煢
怼	懟
镚	鏰
𫎦	贚
𫂿	𥻦
缗	緡
棁	梲
𬇙	𬇙
鹯	鸇
仅	僅
𫚭	鱲
溪	渓
㟆	㠏
箪	簞
佣	傭
䝙	貙
寝	寝
夺	奪
娱	娛
块	塊
𪉈	鴜
贯	貫
栖	棲
亩	畝
郓	鄆
啭	囀
轪	軑
呙	咼
𦈙	䌰
𨸂	閍
馄	餛
鬶	鬹
𩠅	𩟐
衮	袞
鲢	鰱
𫄤	繨
势	勢
𨱇	銶
储	儲
廪	廩
顼	頊
辂	輅
潴	瀦
蚝	蠔
𩠏	𩞦
傧	儐
鸺	鵂
䲝	䱽
丢	丟
顽	頑
䑽	𦪙
鳄	鱷
龚	龔
凛	凜
铲	鏟
𪿫	礮
𫔵	䦯
碎	砕
𫜂	𪅂
诲	誨
𥱔	𥵃
黄	黄
鿎	䃮
头	頭
对	対
锺	鍾
灯	灯
缓	緩
𫟲	釚
弥	弥
舣	艤
镤	鏷
䜥	𧩙
欲	欲
荤	葷
钕	釹
鲑	鮭
䦶	䦛
忆	憶
阁	閣
殚	殫
阆	閬
缆	纜
壹	壱
铀	鈾
癣	癬
阖	闔
颥	顬
䦁	𨧜
谵	譫
钞	鈔
𥐰	𥕥
广	広
𫓫	𨥟
𫘽	鬠
趸	躉
积	積
𬭊	𨧀
鲯	鯕
𪚏	𪘀
窝	窩
篮	籃
颞	顳
𫏨	𨇤
𫔕	𨰥
𫄸	纁
𬶏	鮠
㛟	𡞵
绾	綰
䴖	鶄
饫	飫
煴	熅
绞	絞
䜩	讌
锤	錘
𫘧	騄
摅	攄
猬	蝟
瞒	瞞
鹄	鵠
𬶋	鮈
济	済
薰	薫
粮	糧
颎	熲
奋	奮
丑	醜
渗	滲
鲽	鰈
烫	燙
颀	頎
鳀	鯷
锅	鍋
鲼	鱝
𬣳	𬣳
驻	駐
逻	邏
𫛝	鴅
澜	瀾
钰	鈺
陈	陳
誊	謄
骎	駸
𪎌	麳
润	潤
𪢸	墲
拣	揀
临	臨
吴	呉
桧	檜
氇	氌
荟	薈
鲻	鯔
给	給
镝	鏑
谒	謁
蝎	蠍
桥	橋
𨸌	𨶮
恻	惻
纾	紓
曾	曽
衔	銜
镅	鎇
搔	掻
𪎊	麨
𫟆	緟
𰰨	𰰨
坏	壊
奂	奐
岩	巌
𪜎	𠿕
园	園
𪸩	煇
䴙	鷿
溃	潰
𩠀	𩚥
𫖒	韠
默	黙
侭	儘
绯	緋
诒	詒
综	綜
𩧦	𩡺
涞	淶
滟	灩
𫘮	䮰
𫟼	鐽
𡒄	壈
飓	颶
𪠵	㖮
卷	巻
响	響
𫟄	綋
颓	頹
𫚙	鯆
罴	羆
钚	鈈
璇	璇
纻	紵
荡	蕩
桨	槳
𦈟	䌝
兖	兗
乱	乱
兹	茲
觊	覬
𪱷	梖
𫄨	絺
璎	瓔
认	認
谣	謡
铏	鉶
𬘯	𬘯
蝼	螻
炜	煒
𥐟	礒
慭	憖
溅	濺
𩽼	鯶
俪	儷
琎	璡
纤	繊
钌	釕
玚	瑒
绕	繞
缤	繽
训	訓
诈	詐
费	費
轲	軻
种	種
敌	敵
骞	騫
鸲	鴝
𬙊	𬙊
胆	胆
拨	撥
挜	掗
丽	麗
𫄷	繶
𩧭	䭿
状	状
𩠊	𩜵
𫗱	䭑
𫟷	鉝
师	師
蓟	薊
画	画
铺	舗
吊	吊
泞	濘
痫	癇
饯	餞
𬸣	𬸣
荦	犖
荬	蕒
喂	喂
巯	巰
贶	貺
鲨	鯊
绤	綌
𩙫	颾
飞	飛
远	遠
𪔭	𪔵
敛	斂
矩	矩
傥	儻
废	廃
驺	騶
阀	閥
𩧿	䮠
页	頁
𫜙	䵴
啬	嗇
𬘩	𬘩
谮	譖
砀	碭
坛	壇
蒏	醟
粤	粵
铨	銓
韧	韌
䀥	䁻
铗	鋏
𫛩	鴳
𫐄	軏
㑩	儸
诧	詫
𫔇	鎞
𩾃	鮸
劢	勱
秋	秋
𫓿	𨨢
縆	緪
𫍡	詑
𣷷	𤅶
双	双
㘎	㘚
颁	頒
妪	嫗
诬	誣
僵	僵
镲	鑔
咙	嚨
悯	憫
钔	鍆
哄	哄
𠲥	𡅏
𫔋	䥗
𫟹	鉷
报	報
弹	弾
轭	軛
𣶭	𪷓
痒	癢
𨱄	鈯
𫁡	鴗
𫚔	鮰
扎	扎
鲔	鮪
殡	殯
赆	贐
铖	鋮
铚	銍
𫖴	𩔳
𬬿	𬬿
𱊜	𱊜
㨫	㩜
㑇	㑳
买	買
语	語
馔	饌
𪨷	巗
鹪	鷦
𪨶	輋
吕	呂
谌	諶
齐	斉
䴘	鷈
举	挙
叆	靉
鹧	鷓
𩽾	鮟
铱	銥
絷	縶
谶	讖
伥	倀
进	進
𤊰	𤓩
𫄭	緮
𣐕	桱
宽	寛
𫠌	𩦠
𫀮	𥢷
挨	挨
怆	愴
饶	饒
鲝	鮺
𫛺	䳧
渊	淵
讷	訥
纹	紋
枪	槍
黾	黽
恼	悩
谊	誼
条	条
𫗧	餗
𫘛	馯
酢	醋
𬤊	𬤊
铠	鎧
娄	婁
缄	緘
钒	釩
剐	剮
鲳	鯧
𫢸	僤
奁	奩
忾	愾
悫	愨
级	級
绉	縐
捡	撿
谅	諒
与	与
钳	鉗
轼	軾
铑	銠
铡	鍘
龈	齦
动	動
𢘝	𢣚
㺍	獱
鹳	鸛
库	庫
荣	栄
绝	絶
𫎧	䝭
鹠	鶹
𫘤	騃
镗	鏜
𫋻	襘
羟	羥
转	転
锲	鍥
沨	渢
𥮜	䉲
娴	嫺
惧	懼
锪	鍃
铇	鉋
镘	鏝
𫖵	𩓥
𫠅	韚
岿	巋
绛	絳
赘	贅
鸨	鴇
玛	瑪
𦈐	縺
诩	詡
𬸚	𬸚
渔	漁
椠	槧
才	才
𪟎	㔋
宫	宮
吁	籲
垆	壚
松	松
疖	癤
镟	鏇
䦷	䦟
颜	顔
𢬍	擫
觋	覡
𪬚	𢣐
昼	昼
𬊈	𬊈
黡	黶
䍁	繸
𪡏	嗹
锯	鋸
践	践
昵	暱
舍	舎
谘	諮
欧	欧
辞	辞
钧	鈞
𪉌	𪁖
𫚒	鮄
掷	擲
酝	醞
鳚	䲁
𫄱	繬
龆	齠
俦	儔
闿	闓
𫗠	餦
骘	騭
𩧼	𩣺
怜	憐
馐	饈
铎	鐸
𫚢	鰋
缘	縁
征	徴
统	統
𬭚	𬭚
庵	庵
𨱎	鍮
瘿	癭
𫟟	詊
𩙧	䬞
𪫷	㦞
桡	橈
帘	簾
肮	骯
秃	禿
苏	蘇
锾	鍰
粜	糶
绱	鞝
达	達
镂	鏤
芈	羋
跹	躚
桠	椏
铐	銬
炝	熗
么	麼
县	県
𤇄	熌
扪	捫
戚	戚
𪶄	溡
获	獲
𩧨	駎
鸧	鶬
萚	蘀
谥	諡
𨅛	䠱
啰	囉
𫚬	𩼶
𫜫	𫜦
敕	勅
谓	謂
𫔏	𨬖
婳	嫿
𫊮	蠦
径	径
滩	灘
𤞃	獩
䙊	𧜵
𪉎	𪂆
𫗞	飦
㶽	煱
稻	稲
浍	澮
爷	爺
饱	飽
诪	譸
怀	懐
骅	驊
滢	瀅
狰	猙
贳	貰
𪣒	堚
𫔰	閞
锩	錈
硗	磽
谈	談
辌	輬
挞	撻
𫖳	頵
祎	禕
𫧮	𫧮
𫍰	諰
畅	暢
肿	腫
罗	羅
饪	飪
𩰰	𩰹
𫍨	誫
浉	溮
𫶇	嵽
鲫	鯽
验	験
鲩	鯇
𬭤	𬭤
紧	緊
项	項
腼	靦
𫎆	豵
㟥	嵾
𦝼	膢
𫁷	䉶
饨	飩
隽	雋
虬	虯
铬	鉻
𪸕	熂
馀	余
鹊	鵲
𫚏	䱁
𬞟	𬞟
輼	轀
𪩎	巊
轶	軼
厂	廠
鲶	鮎
帻	幘
蔑	蔑
𬕂	𬕂
锕	錒
胨	腖
揽	攬
邻	鄰
罂	罌
占	佔
龌	齷
胪	臚
𩽺	𩵩
谫	譾
茧	繭
𬩽	𬩽
炉	炉
𨐉	𨎮
𫎺	䟃
颦	顰
霁	霽
𨱌	鏆
准	準
𨱒	鏉
讼	訟
羁	羈
册	冊
烬	燼
铻	鋙
𫐒	輷
诔	誄
銮	鑾
𬴊	𬴊
颋	頲
缪	繆
拦	攔
钅	釒
𨱂	鈋
𫔃	𨰲
㻘	𤪺
扰	擾
糍	餈
锋	鋒
镆	鏌
𪪼	彃
锔	鋦
荥	滎
锓	鋟
盏	盞
䲞	𩶘
𫛰	䳢
𫟽	𨧰
䥽	鏺
赪	赬
㳡	濄
𬭯	𬭯
𫠀	䥄
贡	貢
铃	鈴
骇	駭
𫸩	彄
鲥	鰣
𫉁	薆
馉	餶
𫍢	譊
𫚘	𩻮
𫀌	𥜰
绑	綁
犹	猶
柜	櫃
侪	儕
𪼋	㻶
鸰	鴒
䌶	䊷
筝	箏
𫔖	𨲳
𫚉	魟
𫍚	訞
勚	勩
轳	轤
羡	羨
试	試
舻	艫
顾	顧
无	無
𥭉	𥵊
薮	藪
𫓶	鋗
𩙯	䬝
讦	訐
沟	溝
𣏢	槫
𩧩	𩤊
𬒈	𬒈
𫈵	蕝
禀	稟
侩	儈
𫄵	𦅈
肴	餚
𫚚	鮿
云	雲
锶	鍶
𡳃	𡳳
恸	慟
漓	漓
缌	緦
𫄩	䋦
伣	俔
缝	縫
𪤄	𡓁
㳔	濧
硚	礄
冁	囅
筹	籌
䶮	龑
贿	賄
胫	脛
锖	錆
组	組
疮	瘡
仆	僕
毡	氈
谎	謊
𪧘	寠
迳	逕
论	論
鹬	鷸
铙	鐃
棱	稜
荛	蕘
涂	塗
纵	縦
𧒭	𧔥
鲵	鯢
豫	予
𩧻	𩣵
绺	綹
晒	曬
涩	渋
殴	殴
䭪	𩞯
虱	蝨
𫗮	餭
为	為
绍	紹
𫠋	騼
𫋷	襗
镞	鏃
涠	潿
鳆	鰒
颔	頷
耻	恥
𫑡	鄳
𬜬	𬜬
轴	軸
𫖶	顅
爱	愛
埘	塒
谷	谷
𬍛	𬍛
𬘓	𬘓
闭	閉
缯	繒
夹	夾
𨱔	鐏
怅	悵
𫜨	䶕
荐	薦
蕲	蘄
𣗋	欓
浐	滻
虏	虜
䴔	鵁
撺	攛
宪	憲
饼	餅
烛	燭
铍	鈹
瑶	瑤
鳞	鱗
唡	啢
鲁	魯
𨱃	鈲
伦	倫
资	資
题	題
颠	顛
䌸	縳
节	節
扑	撲
𫔉	𨰃
咨	諮
讱	訒
荆	荊
𡺄	嶘
尽	尽
𢫞	𢶫
𩭹	鬖
𪩸	幩
鹦	鸚
𫬐	𫬐
触	触
濑	瀬
咏	詠
𫝧	㜐
橥	櫫
轾	輊
蒇	蕆
骏	駿
𫛚	鳽
暨	曁
核	核
减	減
𨸘	𨽏
禅	禅
锃	鋥
𬇹	𬇹
𫓭	鉠
农	農
犊	犢
赟	贇
𪳗	𣜬
骉	驫
烩	燴
瑸	璸
鸥	鴎
诟	詬
轫	軔
𫅗	羵
𦍠	䍽
𫘞	駞
谀	諛
峰	峰
鳖	鼈
珑	瓏
掺	摻
鳐	鰩
鳢	鱧
𬬹	𬬹
闲	閒
藏	蔵
亵	褻
刮	刮
翘	翹
㭴	樫
蕰	薀
𫄮	䋼
嵝	嶁
𪨗	屩
𩓋	顂
惨	惨
𫍷	謉
欢	歓
轺	軺
𫞨	璼
怄	慪
沪	滬
𨸋	𨶲
㐽	偑
炽	熾
庐	廬
䥾	䥱
𬍡	𬍡
仓	倉
𨤰	𨤻
辖	轄
谪	謫
鲦	鰷
𫞝	灍
奥	奥
灿	燦
绳	縄
郐	鄶
𫄶	繈
谇	誶
启	啓
细	細
𬘫	𬘫
𫚌	魦
镓	鎵
籴	糴
㧐	㩳
糇	餱
鹡	鶺
𫠁	鑉
谰	讕
𬤝	𬤝
观	観
豮	豶
谤	謗
鲍	鮑
䍀	繿
连	連
𫏑	𨇽
鲣	鰹
鼌	鼂
睐	睞
𤆡	熓
俣	俁
鹁	鵓
𡭬	𡮣
纴	紝
鳃	鰓
𩏿	䪘
𪫡	𢤩
鹴	鸘
𧮪	詀
绮	綺
咛	嚀
榈	櫚
声	声
贩	販
变	変
鳈	鰁
鹛	鶥
𫍬	誷
辍	輟
埙	壎
钥	鑰
谉	讅
胡	胡
𪉕	𪇳
锆	鋯
玑	璣
蛲	蟯
疱	皰
箩	籮
鹱	鸌
鳊	鯿
𫐅	軕
满	満
闪	閃
𫚡	鯞
魉	魎
𫎪	䞋
阋	鬩
𬭛	𨨏
纨	紈
开	開
𬂩	𬂩
锑	銻
𪮳	𢺳
岖	嶇
仪	儀
𫖺	䫶
蜗	蝸
𫔲	𨴹
䌻	䋚
𤶊	癐
囵	圇
苈	藶
风	風
苹	蘋
击	撃
艺	芸
戾	戻
挚	摯
镄	鐨
骢	驄
𬳽	𬳽
𩙮	䬘
垴	堖
墙	牆
绔	絝
𪉉	𪁈
馕	饢
疡	瘍
雇	僱
骤	驟
挝	撾
𫜔	䴽
铘	鋣
赡	贍
跸	蹕
德	徳
𥎝	䂎
编	編
亲	親
评	評
够	夠
顺	順
𫄜	䋃
铋	鉍
𫓷	𫒡
让	譲
𫗫	餬
馁	餒
闼	闥
𫛷	鶦
约	約
毵	毿
篱	籬
吃	喫
罚	罰
𣽷	瀃
𬺈	𬺈
拧	擰
鹨	鷚
钶	鈳
钊	釗
锵	鏘
𫔑	𨭖
𩨇	䮫
鳟	鱒
阚	闞
塆	壪
家	家
𫍤	譑
残	残
琼	瓊
俩	倆
郦	酈
酽	釅
鹞	鷂
𫚍	魵
岁	歳
沄	沄
讻	訩
谜	謎
鞯	韉
纩	纊
𫓲	銁
㛀	媰
赃	贓
檩	檁
㱩	殰
邹	鄒
龃	齟
𪡋	噞
擜	㩵
闬	閈
碛	磧
俨	儼
𪨊	㞞
酦	醱
𫉄	藷
𫓼	𨨛
桪	樳
镜	鏡
戬	戩
颃	頏
挂	掛
范	範
𪧀	孾
诊	診
该	該
参	参
步	歩
𫛵	鶌
枢	枢
谧	謐
㳠	澾
褴	襤
汉	漢
镩	鑹
暧	曖
镔	鑌
昽	曨
跖	跖
洒	灑
鲈	鱸
鹑	鶉
狝	獮
折	折
婴	嬰
纫	紉
𩲒	𩳤
𫍥	誂
鲘	鮜
哓	嘵
𪽭	𤷃
砻	礱
砺	礪
滥	濫
𫛦	鴮
矿	礦
郸	鄲
𫞛	㶆
修	修
𬬭	錀
蚂	螞
属	属
扣	扣
气	気
确	確
𠰷	嚧
𫇽	蕽
蔂	虆
伞	傘
𠯟	哯
浇	澆
䅟	穇
𧑏	蠾
荭	葒
𫞠	爧
沾	沾
笋	筍
屃	屓
杠	槓
𩠈	䭃
馎	餺
𫗴	饘
𩨎	龭
𪵣	霼
𫛪	鴽
检	検
𪽈	畼
谢	謝
骁	驍
骆	駱
骠	驃
损	損
暗	暗
瘾	癮
办	辦
荝	萴
𦈒	𦂅
𫚜	䲅
缥	縹
搂	摟
躯	軀
铉	鉉
𫅼	𦔖
𫔆	䥯
𫚞	鯬
𫓥	釟
锦	錦
芸	芸
鹏	鵬
汇	匯
访	訪
皑	皚
贱	賤
𥆧	瞤
镁	鎂
哒	噠
纺	紡
误	誤
伛	傴
辔	轡
腘	膕
鲄	魺
𡸃	𡽗
贞	貞
𪺷	獊
伫	佇
栗	慄
协	協
𬬮	𬬮
𫝵	嶹
护	護
𬸘	𬸘
铝	鋁
钖	鍚
晔	曄
蒋	蒋
铼	錸
𤊀	𤒎
书	書
瘪	癟
鲹	鰺
于	於
鳏	鰥
𩧲	駧
惯	慣
㧏	掆
绵	綿
𣃁	斸
晖	暉
纷	紛
恳	懇
诮	誚
刭	剄
峤	嶠
结	結
堑	塹
钻	鑽
讣	訃
觑	覷
𩯒	𩯳
𡋀	𡓾
𩨃	騝
讬	託
裆	襠
泪	涙
𫚟	𩸡
辑	輯
擞	擻
𫛭	鵟
晓	暁
缐	線
辁	輇
闩	閂
每	毎
鹂	鸝
赚	賺
𣎑	臗
绐	紿
呒	嘸
咝	噝
潜	潜
𫐊	軬
𫓹	錤
𫐖	轇
𫚧	鰽
识	識
铣	銑
𫋌	蟘
𪨹	𡹬
𫞩	璊
愈	愈
镵	鑱
况	況
唢	嗩
抚	撫
壤	壌
碱	鹸
䙌	䙡
挣	掙
钙	鈣
刽	劊
𫍽	譞
揾	搵
毁	毀
𥅘	𥌃
医	医
𩨀	騔
蝈	蟈
狱	獄
驵	駔
𡭜	𡮉
镢	钁
购	購
术	術
沈	沈
䌿	䋹
猫	猫
锛	錛
𫛲	鵰
箫	簫
钽	鉭
雕	雕
闶	閌
𫍐	𧭹
𫎸	𧽯
荜	蓽
𫍟	𧦧
苔	苔
髋	髖
𫘯	驓
𪴙	欑
问	問
驱	駆
荔	茘
𫜬	齰
𬷕	𬷕
钏	釧
裥	襉
𫓦	釨
栎	櫟
䗖	螮
阃	閫
颡	顙
𨱁	鈠
雏	雛
𫄯	𦃩
鲇	鮎
背	背
锁	鎖
饦	飥
𫗊	䬓
谔	諤
鹥	鷖
志	志
蜕	蛻
没	没
绀	紺
𫜳	䶲
𢛯	㦎
𪼴	𤬅
𫗇	䫻
龉	齬
胁	脅
彟	彠
几	幾
枫	楓
诽	誹
𫐐	輗
诸	諸
郧	鄖
𫛧	𪀖
𪉋	𪀾
贼	賊
𪺻	㺜
蟏	蠨
𫠂	閝
𫖸	願
媪	媼
䦂	䥇
抛	拋
涛	涛
闸	閘
亚	亜
锹	鍬
胶	膠
𨸉	𨶀
𩾎	𩽇
饸	餄
𫐍	𨌈
酂	酇
横	横
迟	遅
𩠋	𩝔
哕	噦
𫖮	顗
驹	駒
峦	巒
𥞦	𥞵
衬	襯
铹	鐒
𠮶	嗰
腊	臘
许	許
𫄪	𦅇
纭	紜
谭	譚
出	出
𫜅	䴋
辨	弁
𨸊	𨶏
脉	脈
𨐈	輄
曲	曲
讳	諱
蹰	躕
霸	覇
谕	諭
镈	鎛
𫟬	𨟊
郏	郟
鳇	鰉
鳑	鰟
峡	峡
涡	渦
御	御
𠛆	𠞆
铓	鋩
经	経
频	頻
𧹒	買
铔	錏
岚	嵐
撄	攖
蚀	蝕
𨱉	鍄
渎	瀆
㛤	孋
涤	滌
镇	鎮
瞆	瞶
袜	襪
鳠	鱯
壳	殻
𩧵	𩢴
钎	釺
𨰿	釳
𫘝	駃
点	点
𫞣	㹽
装	装
搀	攙
𪢌	㘓
鲕	鮞
𠯠	噅
𫍙	訑
荙	薘
崃	崍
岭	嶺
𪮖	撧
𪪏	廬
𫏆	蹳
𫟡	誴
湿	湿
鹍	鵾
觉	覚
𫙂	𩯁
铰	鉸
缭	繚
闹	鬧
蓦	驀
裈	褌
𫔂	鍉
𫁟	竱
诛	誅
妩	嫵
硕	碩
𫚈	鱮
𫟠	譂
课	課
孪	孿
鸣	鳴
记	記
铸	鋳
绢	絹
𫞚	澬
𤈷	㷿
𣲘	潕
嵘	嶸
黉	黌
𦈌	綀
𣍰	脥
呛	嗆
垯	墶
尝	嘗
𪻐	瑽
𫎬	贑
𫊻	蟳
盐	塩
𫎌	貗
树	樹
橼	櫞
鹈	鵜
疎	疏
纪	紀
厨	廚
渖	瀋
𢠁	懎
𣘷	𣝕
礼	礼
𨁴	𨅍
钛	鈦
𨱊	𨧱
䦀	𨦫
㤘	㥮
锝	鍀
𬬻	鑪
闻	聞
𢋈	㢝
国	国
殓	殮
𨸇	𨵸
轿	轎
𫟕	䕤
陷	陥
𩨊	騚
哝	噥
筛	篩
逊	遜
听	聴
𫍵	謸
骄	驕
𫝬	嬇
币	幣
䓕	薳
场	場
𫜓	𪌭
韬	韜
潇	瀟
侨	僑
䁖	瞜
朱	朱
𫍝	諫
滞	滞
阕	闋
蛎	蠣
𫰛	娙
斗	闘
𫝨	媈
缚	縛
联	連
柽	檉
黪	黲
𩠠	𩠴
𫏋	蹻
𫕨	𩅙
汹	洶
泶	澩
蜡	蝋
铽	鋱
垲	塏
𪩘	巘
籁	籟
骦	驦
悭	慳
䜤	鿁
𪪞	廧
𫄝	𥾯
丰	豊
骛	騖
赣	贛
鹖	鶡
𦈔	縎
筑	築
潆	瀠
怿	懌
灵	霊
贲	賁
鹾	鹺
稳	穏
躜	躦
瘫	癱
𫓪	鈆
讽	諷
𬳵	𬳵
膑	臏
贠	貟
撸	擼
𪵱	濿
纽	紐
匀	匀
痈	癰
𫄟	絁
椟	櫝
标	標
𣘴	檭
庑	廡
咽	咽
叁	叄
读	読
缜	縝
采	採
𥐻	碙
赕	賧
轰	轟
𪮃	㨻
𫝈	㑮
它	它
浔	潯
硷	礆
侦	偵
淀	澱
㥪	慺
镛	鏞
觐	覲
𫟫	𨞺
玙	璵
𫛤	鴐
鹲	鸏
韩	韓
尔	爾
迹	跡
颧	顴
锐	銳
较	較
钼	鉬
奖	獎
𦶻	𦾟
劲	勁
华	華
锎	鐦
历	歴
鹚	鶿
齑	齏
𫍿	譾
巩	鞏
锻	鍛
𫗤	𩛌
鳓	鰳
镉	鎘
𪢕	嚽
闽	閩
梼	檮
稆	穭
圣	聖
𫄚	䊺
𪠸	嚛
极	極
𫚦	鰫
话	話
𡳒	𦘧
狈	狽
兽	獣
暂	暫
贤	賢
缑	緱
饭	飯
哜	嚌
蔷	薔
垅	壠
陉	陘
巅	巔
须	須
𫂈	䉬
发	発
锗	鍺
尴	尷
拔	抜
鲸	鯨
舱	艙
髌	髕
鹎	鵯
𩨐	𩧆
𩾊	䱬
绣	繍
独	独
骔	騌
战	戦
军	軍
镊	鑷
鳘	鰵
䯅	䯀
镧	鑭
兑	兌
辒	轀
仑	侖
厌	厭
伤	傷
绒	絨
绩	績
狞	獰
鸯	鴦
𤇃	爄
𫇘	𦧺
凿	鑿
徕	徠
颏	頦
驼	駝
签	籤
𦛨	朥
𫞷	𥢶
绊	絆
𫐔	𨍰
槟	檳
娘	娘
𨱐	𨫒
带	帯
厮	廝
𫋹	襓
吓	嚇
𦈏	緍
觅	覓
婵	嬋
觃	覎
应	応
𧉞	䗿
橹	櫓
骖	驂
佥	僉
驯	馴
娅	婭
𫔮	閒
假	仮
𠀾	𠁞
𪉆	鴲
铈	鈰
㑈	倲
诹	諏
讠	訁
闷	悶
𫛣	鴥
将	将
偻	僂
铜	銅
𫗰	䭔
𨸁	𨳑
馆	館
𨄄	𨈌
蚬	蜆
铒	鉺
𫎱	䟐
肃	粛
𨸅	𨴗
𤎺	㸇
蓠	蘺
韦	韋
𫘱	驨
㤽	懤
虫	虫
窥	窺
饲	飼
䌹	絅
𣳆	㵗
𩨈	騟
𫚨	𩻗
邝	鄺
嘘	嘘
来	来
镑	鎊
韫	韞
现	現
侬	儂
赖	頼
𦈓	䋿
𫔶	闑
𪉔	𪄆
镀	鍍
纬	緯
谍	諜
俫	倈
𦻕	蘟
哗	譁
讥	譏
㴋	潚
炖	燉
驭	馭
辘	轆
𨐇	𨏠
𧝧	𧟀
诜	詵
赈	賑
𫐈	軷
谦	謙
𣈣	𣋋
𫐏	輖
颛	顓
驴	驢
痉	痙
𬪩	𬪩
懔	懍
䞍	䝼
压	圧
汤	湯
𫭢	𫭢
𪩇	㟺
𫟴	鈖
䇲	筴
杂	雑
舰	艦
酿	醸
𫜰	齾
鹐	鵮
轹	轢
间	間
鲅	鮁
姜	姜
板	板
凭	憑
𡶴	嵼
恹	懨
𪭾	撊
群	群
𫜒	䴱
𩩈	䯤
致	致
颒	頮
𫚗	鮯
𬤇	𬤇
莶	薟
复	復
𬳿	𬳿
骟	騸
唛	嘜
绹	綯
圈	圏
𧹔	賬
谙	諳
𪉃	鳼
𪿊	𥏝
颙	顒
备	備
饻	餏
𥩺	𥪂
𥫣	籅
饰	飾
质	質
𫐷	遱
𰾭	𰾭
余	余
朴	樸
㻏	𤫩
攒	攢
𫓻	錜
犸	獁
𪶒	𤄷
䅪	𥢢
𫐎	輢
𫠆	頍
䓨	罃
视	視
𫔓	𨯟
澛	瀂
绌	絀
设	設
疠	癘
𫍫	䛳
呓	囈
帏	幃
𪽷	瘱
铛	鐺
𦈚	縬
𬀪	𬀪
昙	曇
𪰶	曊
蚕	蚕
鲭	鯖
锜	錡
缠	纏
𫠑	䱸
𢙓	懀
悬	懸
总	総
𩧱	𩥉
痴	痴
𩨂	驄
谛	諦
蚃	蠁
岂	豈
𨸆	𨵩
饩	餼
鲆	鮃
龅	齙
毶	毿
祷	祷
借	借
谐	諧
谋	謀
赍	齎
涝	澇
𩨅	𩤸
锨	杴
㧟	擓
恤	恤
恶	悪
瓒	瓚
盘	盤
杀	殺
谗	讒
𫛾	𪆷
尘	塵
𨸎	𨷲
颈	頸
义	義
𨱀	𨥛
𫓵	鋠
辈	輩
𬟁	𬟁
犷	獷
嫒	嬡
雠	讎
颊	頰
镍	鎳
渍	漬
栋	棟
痨	癆
妆	粧
跃	躍
阈	閾
𨡙	𨢿
唇	唇
乔	喬
𪨧	崙
箨	籜
钾	鉀
颍	潁
黩	黷
鼍	鼉
箧	篋
队	隊
𤽯	㿧
𪲛	檵
𫐕	轊
鳍	鰭
鹮	䴉
垭	埡
𫖔	韛
𫚝	𩸄
轧	軋
谠	讜
鲡	鱺
𢭏	擣
败	敗
恺	愷
蓣	蕷
𢢐	𤢻
𩠆	𩜦
请	請
𪵑	毊
陧	隉
緖	緒
媭	嬃
热	熱
粹	粋
𫐘	轗
皱	皺
𫐉	軨
萝	蘿
𪢐	𡃤
颇	頗
滚	滾
𫛟	鸗
𬭼	𬭼
骗	騙
㚯	㜄
亘	亘
绿	緑
铌	鈮
疗	療
傩	儺
𫗉	𩗴
炀	煬
㛠	𡢃
布	布
领	領
鹙	鶖
窜	竄
绁	紲
狮	獅
谖	諼
𤎻	𤑳
𪉒	𪄕
莴	萵
锸	鍤
𫔭	開
诤	諍
㧰	擽
幂	冪
恽	惲
颗	顆
锞	錁
谬	謬
𫔎	鐍
贪	貪
𨱏	鎝
同	同
𫔈	鎙
𪢮	圞
呖	嚦
续	続
趋	趨
顷	頃
䲠	鰆
𬘘	𬘘
𡞱	㜢
𤈶	熉
垫	墊
𠵾	㗲
矫	矯
𠋆	儭
𫛹	𪃧
窑	窯
誉	誉
觏	覯
揿	撳
鹘	鶻
搅	撹
觎	覦
𫜕	𪍠
𩠃	𩛩
𪹳	爥
跻	躋
筚	篳
输	輸
缞	縗
粪	糞
熏	薫
鸶	鷥
时	時
𩧴	駩
竖	豎
䥿	𨯅
谱	譜
绠	綆
椫	樿
缛	縟
鬓	鬢
𫚖	鮆
𬭳	𨭎
鲜	鮮
计	計
𫌀	襀
诌	謅
𥬞	籋
𣱝	氭
麸	麩
绚	絢
寿	寿
珰	璫
纲	綱
绽	綻
缙	縉
𡞋	㜗
𪡛	㗿
𫍮	誳
纥	紇
鹒	鶊
闵	閔
𤩽	瓛
哑	唖
挤	擠
笺	箋
错	錯
厍	厙
捣	搗
辐	輻
摊	攤
裢	褳
鸡	鶏
鲌	鮊
𫘡	駫
𫗋	飋
浃	浹
锷	鍔
陕	陝
担	担
峥	崢
殁	歿
脚	脚
枭	梟
苌	萇
邬	鄔
镙	鏍
彻	徹
挠	撓
浓	濃
载	載
悮	悞
钵	鉢
骜	驁
𫁂	䆉
𫄞	䋔
𫎩	賝
赊	賒
缕	縷
锽	鍠
鹢	鷁
𩧫	駚
缺	欠
练	練
团	団
虚	虚
壮	壮
样	様
涌	湧
瘘	瘻
㓰	劃
跷	蹺
纳	納
钨	鎢
赝	贋
𩨍	𩥇
贸	貿
𦈡	繻
铯	銫
查	査
惮	憚
赛	賽
𣍯	腪
缫	繅
辀	輈
蝾	蠑
鲠	鯁
缦	縵
尸	屍
𠛅	剾
𩧯	驋
钭	鈄
𦈕	緰
𥹥	𥼽
霭	靄
诏	詔
货	貨
面	面
骕	驌
鲀	魨
𫀨	䅐
䩄	靦
赙	賻
镯	鐲
钺	鉞
纟	糹
𫄡	絧
𦈝	繏
颟	顢
𪽝	𤳷
诣	詣
𬬸	𬬸
滨	浜
只	只
鲓	鮳
赐	賜
𫍠	䛄
涧	澗
刍	芻
际	際
𬴂	𬴂
𪉏	𪃏
传	伝
赜	賾
彦	彦
𫔐	𨭸
㭤	樢
𩠇	䭀
额	額
铅	鉛
铢	銖
沦	淪
嚣	囂
萤	蛍
轨	軌
𪉐	𪃍
辅	輔
阗	闐
濒	瀕
𨱖	䥩
鿔	鎶
鲉	鮋
虽	雖
凤	鳳
𣍨	𦢈
垩	堊
边	辺
𦈎	繟
馈	饋
𬶨	𬶨
简	簡
𫚥	鰕
纣	紂
裤	褲
绲	緄
𨑹	䢨
镦	鐓
钓	釣
晕	暈
麦	麦
赔	賠
过	過
𫄙	糺
镣	鐐
伪	偽
孙	孫
𫛞	鴃
𨱓	鐎
𫐌	軿
𪨩	𡸗
长	長
𪭝	𢯷
藓	蘚
䃅	磾
醖	醞
𫓰	銊
抠	摳
馒	饅
览	覧
𥺅	䊭
拥	擁
疯	瘋
缲	繰
杨	楊
缒	縋
缴	繳
阘	闒
髅	髏
箦	簀
𥅴	䀹
𩧰	䮝
𨡺	𨣈
鹝	鷊
𫋲	䙔
赒	賙
椢	槶
屡	屢
𪮶	攋
陨	隕
轮	輪
𨂺	𨈊
烟	煙
证	証
赎	贖
镶	鑲
闱	闈
骙	騤
鳡	鱤
踌	躊
鞲	韝
鸱	鴟
肠	腸
诶	誒
鹭	鷺
𬭶	𨭆
适	適
脍	膾
吨	噸
妇	婦
阅	閲
喷	噴
骀	駘
𬯎	𬯎
垒	塁
缢	縊
驮	馱
㑔	㑯
诞	誕
𫟾	𨩰
烃	烴
𪣻	塿
𫍩	諣
𫖹	顣
席	席
𨱆	龯
𫘠	駤
决	決
帮	幫
𫜲	龓
洼	窪
电	電
渐	漸
蔹	蘞
跄	蹌
䜣	訢
钝	鈍
𠛾	𪟖
𩏼	䪏
𩬣	𩭙
骡	騾
庼	廎
颤	顫
鳛	鰼
𨐅	軗
祸	禍
窭	窶
啧	嘖
𫗯	餱
脱	脱
颌	頜
䌺	䋙
𫘬	騱
扩	拡
兰	蘭
𫍜	詓
𩖖	顃
䌷	紬
鹌	鵪
鹉	鵡
钣	鈑
锧	鑕
桦	樺
䏝	膞
苋	莧
鸪	鴣
𬀩	暐
谨	謹
馇	餷
𫓩	鏦
硁	硜
庞	龐
锄	鋤
阂	閡
蘖	櫱
𫗵	饟
讶	訝
鲚	鱭
辉	輝
镎	鎿
𩠁	𩚵
𤇹	熚
𫝭	孆
浕	濜
歼	殲
𪎉	麲
𬶐	𬶐
𫏕	𨆪
辆	輌
崭	嶄
𫍦	譨
泺	濼
腻	膩
踯	躑
谂	諗
瓯	甌
郁	鬱
会	会
辄	輒
碍	礙
𫂃	簢
撑	撐
莹	瑩
疬	癧
畴	疇
围	囲
𣘐	㯤
𣚚	欘
𫖓	𩏂
𫟻	銂
𬭸	𬭸
馋	饞
𫘣	駻
𫋇	蟂
钗	釵
叠	畳
辎	輜
鸮	鴞
㳽	瀰
鲲	鯤
𫜟	𪓰
醉	酔
𩙪	颷
枞	樅
张	張
讵	詎
绫	綾
阉	閹
骣	驏
𢙐	憹
𫄦	𦀖
𫄫	綟
蛱	蛺
谏	諫
𫈟	蔯
𫧃	𫧃
穷	窮
负	負
𩙭	𩘝
𪩛	𡿖
搜	捜
𫖪	𩑔
楼	楼
鹣	鶼
咒	呪
叙	叙
𫖖	𩏠
惊	驚
显	顕
扫	掃
𫍭	𧩕
𫚣	鯾
𫚤	鰦
𧹓	𧶔
携	攜
𫟅	綡
枥	櫪
𫟸	鉽
荪	蓀
𫏌	𨂐
𬘬	𬘬
妫	嬀
顿	頓
钹	鈸
𣯣	𣯩
鱿	魷
𫗈	𩗓
咸	鹹
铟	銦
𬸯	𬸯
赂	賂
榇	櫬
𫎨	𧸘
𩧪	䮾
刾	㓨
𡍣	𡔖
𫘪	騵
矶	磯
窦	竇
袅	嫋
啴	嘽
龄	齢
蒉	蕢
挥	揮
灶	竈
蒀	蒕
𪽴	𤺔
缍	綞
毂	轂
户	戸
鳜	鱖
𫀓	𥜐
旧	旧
后	後
𩨄	騪
𫔍	鐇
𫘫	騴
榝	樧
㱮	殨
滪	澦
嘤	嚶
宝	宝
崄	嶮
掳	擄
钪	鈧
𫂆	簂
增	増
贷	貸
鸟	鳥
念	念
蔺	藺
苎	苧
缃	緗
诨	諢
吗	嗎
𪾢	睍
险	険
䞎	𧶧
镪	鏹
鳁	鰮
鹀	鵐
诵	誦
词	詞
阌	閿
轸	軫
浆	漿
驶	駛
惬	愜
强	強
权	権
厩	廄
绬	緓
诂	詁
随	随
𦈖	䌈
缔	締
𣒌	楇
𫍹	謯
𫓴	鉾
𫗦	餔
𤋏	熡
𫛯	鶭
滦	灤
诿	諉
讫	訖
态	態
𫓯	銈
𫄲	縸
镃	鎡
镐	鎬
龇	齜
拟	擬
栊	櫳
𣘓	𣞻
鳗	鰻
䌾	䋻
辗	輾
𦈋	綇
𫭟	𫭟
阄	鬮
铥	銩
网	網
娆	嬈
麽	麼
龊	齪
𫓮	𨪕
骐	騏
鲋	鮒
𥅿	𥊝
顸	頇
养	養
𫗨	𩛡
猕	獼
𪻺	璝
缏	緶
鸴	鷽
𬨎	𬨎
刚	剛
𫓳	𨰋
𫖱	䫀
镰	鐮
𫛡	鴔
绸	綢
𫌪	覛
𩠉	𩜇
𫜭	齭
员	員
𢫬	摋
𫍧	誺
绎	繹
届	届
贬	貶
咤	吒
𫄳	縰
𫘜	馼
𫟶	銏
𬭁	𬭁
升	升
严	厳
𩠂	𩛆
𢙑	𢠼
聋	聾
𫌋	𧞫
𬭩	𬭩
𫚐	䱀
晚	晩
诱	誘
亸	嚲
调	調
掸	撣
脐	臍
𪷍	㵾
讹	訛
私	私
揭	掲
妈	媽
觞	觴
纼	紖
𢗓	㦛
遥	遙
药	薬
顶	頂
预	預
闾	閭
驷	駟
矾	礬
纯	純
温	温
钋	釙
荩	藎
伧	傖
遗	遺
𬍤	𬍤
𫠈	䫾
迁	遷
崂	嶗
马	馬
谟	謨
傤	儎
优	優
𬮿	𬮿
峣	嶢
刬	剗
鸤	鳲
哟	喲
缮	繕
祢	禰
𠡠	勑
䦃	鐯
䲡	鰌
耧	耬
饧	餳
𥐯	𥖅
𧜭	䙱
𫚑	鮅
处	処
并	並
𫔴	閵
茏	蘢
净	浄
𬜯	𬜯
浈	湞
钑	鈒
莲	蓮
涨	漲
𩾆	𩸦
饳	飿
𫅅	䍤
𪢖	𡅯
𫞅	𦠅
膻	羶
辕	轅
秾	穠
斓	斕
讲	講
𪉑	鷔
维	維
钬	鈥
争	争
饤	飣
鸻	鴴
镳	鑣
帐	帳
织	織
𣶫	𣿉
𫔯	閗
辫	辮
𫔽	𨼳
洁	潔
舆	輿
𬱟	𬱟
驲	馹
冲	衝
挢	撟
鲟	鱘
𪎋	䴴
锱	錙
飨	饗
贝	貝
𠆲	儣
𥬠	篘
饥	飢
鱽	魛
茎	茎
诚	誠
鹕	鶘
聪	聡
辙	轍
笼	籠
𪲔	欐
赗	賵
𬒗	𬒗
鹔	鷫
𣲗	湋
𫍪	誋
𫅭	䎙
镌	鐫
辏	輳
馂	餕
饴	飴
硖	硤
却	却
奸	奸
𬘭	𬘭
谆	諄
㶶	燶
钜	鉅
㭣	𣙎
秘	秘
𫊪	䗅
㛣	㜏
㛿	𡠹
鲙	鱠
两	両
桢	楨
𪡃	嘪
厅	庁
娇	嬌
阙	闕
浏	瀏
𫗬	餪
𫟃	絍
绷	繃
颚	顎
雾	霧
锢	錮
穞	穭
𣞎	𣠩
褛	褸
艰	艱
𪺣	𤘀
鲂	魴
鹗	鶚
叶	葉
茔	塋
贮	貯
辇	輦
鸭	鴨
𣐤	欍
𫄹	纗
萦	縈
𩨉	𩤲
怃	憮
橱	櫥
𨐆	𨊻
𫐑	輨
椭	橢
𪟝	勣
㧑	撝
䴓	鳾
税	税
选	選
㖞	喎
𫁳	𥯤
𨸀	𨳕
𫘰	驙
𫛜	鴀
𬙂	𬙂
浅	浅
飖	颻
说	説
饹	餎
诙	詼
收	収
荧	熒
们	們
驾	駕
趱	趲
掴	掴
鲷	鯛
沧	滄
𫍲	謏
旋	旋
诼	諑
𫚠	䱧
𫗡	𩚩
鱼	魚
厦	廈
𣆐	曥
䴕	鴷
沥	瀝
胧	朧
呐	吶
𫍞	𧦝
𬊤	𬊤
锥	錐
𪽪	痮
丧	喪
辟	闢
猎	猟
鳤	䲘
绅	紳
𠴛	𡃕
凯	凱
鸳	鴛
埚	堝
鲤	鯉
溁	濚
贴	貼
𣑶	𣠲
励	励
匦	匭
铄	鑠
厣	厴
偿	償
𧝝	襰
缧	縲
饮	飲
鸹	鴰
莅	蒞
𨸃	閐
䓖	藭
𫷷	廞
䙓	襬
效	効
鲛	鮫
苁	蓯
瘗	瘞
鑛	鉱
图	図
阎	閻
𤳄	𤳸
𫇴	蒭
𪬯	𢤿
𤾀	皟
泾	涇
饺	餃
谄	諂
锉	銼
钷	鉕
𪲎	櫅
谑	謔
𤝢	𤢟
𫟺	䤤
𥬀	䉙
𬬱	𬬱
袭	襲
𫔒	𨮳
䌼	綐
鸬	鸕
聍	聹
㔉	劚
纠	糾
陆	陸
娈	孌
骧	驤
译	訳
𫄛	紟
𫠒	鱆
槚	檟
衅	釁
癫	癲
𫜁	鷩
圆	円
浊	濁
绨	綈
螨	蟎
铊	鉈
弯	弯
砜	碸
愦	憒
愤	憤
觯	觶
枣	棗
玺	璽
择	択
𫐋	𨎌
坝	壩
线	線
钇	釔
𪭯	𢶒
𪭵	掚
阶	階
𬮱	𬮱
鲐	鮐
穰	穣
𫛢	鸋
𫘩	騜
𪠟	㓄
𫛼	䳫
这	這
𫟇	𦆲
众	衆
软	軟
弑	弒
锿	鎄
捞	撈
觇	覘
牦	犛
骂	罵
杰	傑
彩	彩
榉	櫸
鲰	鯫
诅	詛
蹒	蹣
𪞝	凙
渌	淥
窎	窵
霡	霢
销	銷
鳙	鱅
𫗟	䬧
𠰱	㘉
铤	鋌
污	汚
铴	鐋
篯	籛
𪠽	噹
蛮	蛮
蹑	躡
违	違
𪿞	𥖲
钐	釤
泸	瀘
鳎	鰨
戯	戱
万	万
欤	歟
𫅥	𦒀
𫛛	鳷
屿	嶼
铞	銱
湾	湾
帼	幗
贾	賈
实	実
骃	駰
𣓿	橯
鳂	鰃
𣨼	殢
𥁢	䀉
莸	蕕
颣	纇
𪠳	唓
阵	陣
难	難
𫫇	𫫇
䢁	𨊸
台	台
𫞥	珼
眬	矓
𫐙	轠
鿏	䥑
岽	崬
椝	槼
