元音	母音
冰棍	冰棒
出租车	計程車
咖喱	咖哩
塑料	塑膠
奔驰	賓士
奶酪	乳酪
几率	機率
方便面	泡麵 速食麵
李彦宏	李彥宏
概率	機率
海内存知己	海內存知己
凉菜	冷盤
的士	計程車
砹	砈
硅	矽
程序不正义	程序不正義
程序正义	程序正義
空气净化器	空氣清淨機
纳米	奈米
自行车	腳踏車
词组	片語
蹦极	高空彈跳
辅音	子音
通过	透過 通過
酰	醯
钫	鍅
钚	鈽
锫	鉳
锝	鎝
锿	鑀
镅	鋂
镎	錼
锎	鉲
镥	鎦
黄宏	黃宏
借记卡	簽帳金融卡
